[
    {
        "levelTilesRows": [
                            "..b........................................................",
                            "..b........................................................",
                            "..b........................................................",
                            "..b........................................................",
                            "..b........................................................",
                            "..b........................................................",
                            "..b........................................................",
                            "..b........................................................",
                            ".....eeee..................................................",
                            "...........................................................",
                            "...........................................................",
                            "...........................................................",
                            "...........................................................",
                            "...........................................................",
                            "...........................................................",
                            "...........................................................",
                            ".b............bb...........................................",
                            ".b............bb..........................................."

                        ],
                        "_comment": "special data: three rotating platforms each with their own args (position, rot-speed, rot-point)",
        "otherLevelData" : {"rotatingPlatforms" : [["arg1", "arg3", "arg3"], ["arg1", "arg3", "arg3"], ["arg1", "arg3", "arg3"]]}
    }
]